0,0,0,0,0,0,23,0,0,0,0,0,0,0
0,0,0,0,0,0,0,0,1,1,1,1,1,0
0,0,0,0,0,0,0,0,0,0,1,1,1,0
25,0,0,0,0,0,0,0,0,34,0,1,1,21
0,0,0,0,0,0,0,0,0,0,0,0,0,0
0,0,0,0,0,0,0,0,0,0,0,1,1,0
0,0,0,0,0,0,0,0,0,0,1,1,1,0
0,0,0,0,0,0,0,0,1,1,1,1,1,0
0,0,0,0,0,0,11,0,0,0,0,0,0,0
