0,0,0,0,0,0,27,0,0,0,0,0,0,0
0,0,0,0,0,29,0,0,0,0,0,0,0,0
0,0,0,0,1,0,0,0,0,0,1,29,0,0
18,0,0,0,0,0,0,29,0,29,0,0,0,26
0,0,0,0,0,0,0,0,0,0,0,40,29,0
0,0,0,0,0,0,0,29,0,29,0,0,0,0
0,0,0,0,1,0,0,0,0,0,1,29,0,0
0,0,0,0,0,0,0,0,0,0,0,0,0,0
0,0,0,0,0,0,24,0,0,0,0,0,0,0
