0,0,0,0,0,0,10,0,0,0,0,0,0,0
0,0,0,0,0,0,0,0,0,29,0,0,0,0
0,0,0,0,0,0,0,0,0,0,0,0,0,0
25,0,0,0,29,0,1,1,0,0,0,0,0,21
0,29,0,0,0,0,1,1,0,0,0,0,0,0
0,0,0,0,29,0,1,1,0,0,0,0,0,0
0,0,29,0,0,0,0,0,0,0,0,0,0,0
0,0,0,0,0,0,0,0,0,29,0,0,0,0
0,0,0,0,0,0,24,0,0,0,0,0,0,0