0,0,0,0,0,0,23,0,0,0,0,0,0,0
0,35,0,0,0,0,0,0,0,0,0,0,35,0
0,0,0,0,0,0,0,1,0,0,0,0,0,0
25,0,0,0,0,0,1,0,1,0,0,0,0,13
0,0,0,0,0,1,0,44,0,1,0,0,0,0
0,0,0,0,0,0,1,0,1,0,0,0,0,0
0,0,0,0,0,0,0,1,0,0,0,0,0,0
0,35,0,0,0,0,0,0,0,0,0,0,35,0
0,0,0,0,0,0,24,0,0,0,0,0,0,0
