0,0,0,0,0,0,15,0,0,0,0,0,0,0
0,0,0,0,30,0,0,0,0,0,0,0,0,0
0,0,0,0,0,0,0,0,0,0,0,0,0,0
25,0,0,0,0,30,1,1,0,0,0,0,0,26
0,0,0,0,0,0,1,1,0,0,0,0,0,0
0,0,0,0,30,0,1,1,0,0,0,0,0,0
0,0,0,0,0,0,0,0,0,0,0,0,0,0
0,0,0,0,0,0,0,0,0,0,0,0,0,0
0,0,0,0,0,0,11,0,0,0,0,0,0,0
