0,0,0,0,0,0,46,0,0,0,0,0,0,0
0,0,0,0,0,0,0,0,30,0,0,0,0,0
0,0,0,0,0,0,39,0,0,0,0,0,0,0
18,0,0,1,0,30,0,0,30,0,1,0,0,17
0,0,0,0,0,0,0,30,0,0,0,0,0,0
0,0,0,1,0,30,0,0,0,0,1,0,0,0
0,0,0,0,0,0,0,0,0,0,0,0,0,0
0,0,0,0,0,0,0,0,0,0,0,0,0,0
0,0,0,0,0,0,16,0,0,0,0,0,0,0