0,0,0,0,0,0,23,0,0,0,0,0,0,0
0,0,0,0,30,0,0,0,0,0,0,0,0,0
0,0,0,0,0,0,0,0,0,0,0,0,0,0
18,0,0,1,1,0,0,30,0,1,1,0,0,26
0,0,0,1,1,0,0,0,0,1,1,0,0,0
0,0,0,1,1,0,0,30,0,1,1,0,0,0
0,0,0,0,0,0,0,0,0,0,0,0,0,0
0,0,0,0,30,0,0,0,0,0,0,0,0,0
0,0,0,0,0,0,24,0,0,0,0,0,0,0
