0,0,0,0,0,0,23,0,0,0,0,0,0,0
0,0,0,0,0,0,0,0,0,0,0,0,0,0
0,0,1,1,1,1,1,1,1,1,1,1,0,0
18,0,1,0,0,7,0,0,43,0,0,1,0,26
0,0,1,0,7,0,0,0,0,43,0,1,0,0
0,0,1,0,0,0,0,0,0,0,0,1,0,0
0,0,1,1,1,1,0,0,1,1,1,1,0,0
0,0,0,0,0,0,0,0,0,0,0,0,0,0
0,0,0,0,0,0,24,0,0,0,0,0,0,0