0,0,0,0,0,0,23,0,0,0,0,0,0,0
0,0,0,0,0,0,0,0,0,32,0,0,0,0
0,0,6,6,6,0,0,0,0,6,6,6,0,0
14,0,6,0,0,0,0,32,0,0,0,6,0,26
0,0,6,0,6,6,6,6,6,6,0,6,0,0
0,0,6,0,0,0,0,0,0,32,0,6,0,0
0,0,6,6,6,0,0,0,0,6,6,6,0,0
0,0,0,0,0,0,0,0,0,0,0,0,0,0
0,0,0,0,0,0,11,0,0,0,0,0,0,0
