9,9,9,9,9,9,9,9,9,9,9,9,9,9
9,0,0,0,0,0,0,0,0,0,0,0,0,9
9,0,2,0,0,2,0,0,3,0,0,3,0,9
9,0,0,0,0,0,0,0,0,0,0,0,0,20
9,0,2,0,0,2,0,0,3,0,0,3,0,9
9,0,0,0,0,0,5,5,0,0,0,0,0,9
9,0,2,0,5,2,5,5,3,5,0,3,0,9
9,0,0,0,5,5,5,5,5,5,0,0,0,9
9,9,9,9,9,9,9,9,9,9,9,9,9,9
