0,0,0,0,0,0,10,0,0,0,0,0,0,0
0,0,0,0,0,0,0,0,0,0,0,0,0,0
0,0,1,0,1,0,1,1,0,1,0,1,0,0
18,31,0,0,0,0,0,0,0,0,0,0,0,26
0,0,1,0,1,0,1,1,0,1,0,1,0,0
0,0,0,0,0,0,0,0,0,0,0,0,0,0
0,31,1,0,1,0,1,1,0,1,0,1,0,0
0,0,0,0,0,0,0,0,0,39,0,0,0,0
0,0,0,0,0,0,24,0,0,0,0,0,0,0