0,0,0,0,0,0,10,0,0,0,0,0,0,0
0,0,0,0,0,0,0,0,0,0,0,0,0,0
0,0,2,0,0,2,0,0,3,0,0,3,0,0
18,0,0,0,0,0,0,0,0,0,0,0,0,17
0,0,2,0,0,2,0,0,3,0,0,3,0,0
0,0,0,0,0,0,5,5,0,0,0,0,0,0
0,0,2,0,5,2,5,5,3,5,0,3,0,0
0,0,0,0,5,5,5,5,5,5,0,0,0,0
0,0,0,0,0,0,16,0,0,0,0,0,0,0
