0,0,0,0,0,0,15,0,0,0,0,0,0,0
0,0,0,0,0,33,0,0,0,0,0,0,0,0
0,0,1,1,0,0,0,0,0,0,1,1,0,0
18,0,0,0,0,0,0,0,0,0,0,0,33,13
0,0,0,0,0,0,1,1,0,33,0,42,0,0
0,0,0,0,0,0,0,0,0,0,0,0,0,0
0,0,1,1,33,0,0,0,0,33,1,1,0,0
0,0,0,0,0,0,0,0,0,0,0,0,0,0
0,0,0,0,0,0,28,0,0,0,0,0,0,0