0,0,0,0,0,0,10,0,0,0,0,0,0,0
0,6,6,6,6,6,0,0,6,6,6,6,6,0
0,6,0,30,0,6,0,0,0,0,6,0,6,0
25,6,0,6,0,6,0,6,6,0,6,30,0,26
0,0,0,6,0,6,0,0,6,0,6,0,6,0
0,6,0,6,30,6,6,0,6,0,6,0,6,0
0,6,0,6,0,0,0,0,6,0,0,0,6,0
0,6,6,6,6,6,0,0,6,6,6,6,6,0
0,0,0,0,0,0,16,0,0,0,0,0,0,0
