0,0,0,0,0,0,23,0,0,0,0,0,0,0
0,0,0,0,0,0,0,4,4,4,4,4,4,0
0,0,0,0,0,0,0,4,4,4,4,4,4,0
25,0,0,46,0,0,45,4,4,46,4,4,4,17
0,4,0,0,0,0,0,0,4,4,4,4,4,0
0,4,0,0,0,0,0,0,4,4,4,4,4,0
0,4,0,0,0,0,0,0,4,4,4,4,4,0
0,4,0,0,0,0,0,0,4,4,4,4,4,0
0,0,0,0,0,0,24,0,0,0,0,0,0,0
